"filename", "language", "Go", "comment", "blank", "total"
"/root/go/src/github.com/geraldkohn/im/internal/gateway/grpc_server.go", "Go", 16, 0, -1, 15
"/root/go/src/github.com/geraldkohn/im/internal/gateway/keep_alive.go", "Go", 1, 0, 0, 1
"/root/go/src/github.com/geraldkohn/im/internal/gateway/ws_server.go", "Go", -6, 0, -2, -8
"/root/go/src/github.com/geraldkohn/im/internal/push/grpc_server.go", "Go", -45, 0, -11, -56
"/root/go/src/github.com/geraldkohn/im/internal/push/init.go", "Go", -67, 0, -11, -78
"/root/go/src/github.com/geraldkohn/im/internal/push/logic.go", "Go", -39, 0, -4, -43
"/root/go/src/github.com/geraldkohn/im/internal/pusher/grpc_server.go", "Go", 45, 0, 11, 56
"/root/go/src/github.com/geraldkohn/im/internal/pusher/init.go", "Go", 90, 0, 12, 102
"/root/go/src/github.com/geraldkohn/im/internal/pusher/logic.go", "Go", 38, 0, 4, 42
"/root/go/src/github.com/geraldkohn/im/internal/transfer/init.go", "Go", 93, 0, 11, 104
"/root/go/src/github.com/geraldkohn/im/internal/transfer/msg_handler.go", "Go", -1, 0, 0, -1
"/root/go/src/github.com/geraldkohn/im/internal/transfer/transfer.go", "Go", -91, 0, -10, -101
"/root/go/src/github.com/geraldkohn/im/pkg/common/constant/defs.go", "Go", 1, 0, 0, 1
"/root/go/src/github.com/geraldkohn/im/pkg/common/db/db.go", "Go", 72, 0, 13, 85
"/root/go/src/github.com/geraldkohn/im/pkg/common/db/model.go", "Go", -67, 0, -13, -80
"/root/go/src/github.com/geraldkohn/im/pkg/common/db/mongo_model.go", "Go", 45, 0, 1, 46
"/root/go/src/github.com/geraldkohn/im/pkg/common/db/mysql_group_model.go", "Go", 33, 0, 9, 42
"/root/go/src/github.com/geraldkohn/im/pkg/common/db/mysql_model.go", "Go", 68, 0, 6, 74
"/root/go/src/github.com/geraldkohn/im/pkg/common/db/mysql_user_model.go", "Go", 21, 0, 6, 27
"Total", "-", 207, 0, 21, 228